16 0 0 0 0 0 0 0 0 0 0 0 0 0 0 0 0 0 0 0 16
16 0 17 17 17 17 17 17 17 17 0 17 17 17 17 17 17 17 17 0 16
16 0 17 0 0 17 0 0 0 17 0 17 0 0 0 17 0 0 17 0 16
16 0 17 17 17 17 17 17 17 17 17 17 17 17 17 17 17 17 17 0 16
16 0 17 0 0 17 0 17 0 0 0 0 0 17 0 17 0 0 17 0 16
16 0 17 17 17 17 0 17 17 17 0 17 17 17 0 17 17 17 17 0 16
16 0 0 0 0 17 0 0 0 17 0 17 0 0 0 17 0 0 0 0 16
16 16 16 16 0 17 0 17 17 17 17 17 17 17 0 17 0 16 16 16 16
0 0 0 0 0 17 0 17 0 0 17 0 0 17 0 17 0 0 0 0 0
0 17 17 17 17 17 17 17 0 17 17 17 0 17 17 17 17 17 17 17 0
0 0 0 0 0 17 0 17 0 0 0 0 0 17 0 17 0 0 0 0 0
16 16 16 16 0 17 0 17 16 16 16 16 16 17 0 17 0 16 16 16 16
16 0 0 0 0 17 0 17 0 0 0 0 0 17 0 17 0 0 0 0 16
16 0 17 17 17 17 17 17 17 17 0 17 17 17 17 17 17 17 17 0 16
16 0 17 0 0 17 0 0 0 17 0 17 0 0 0 17 0 0 17 0 16
16 0 17 17 0 17 17 17 17 17 17 17 17 17 17 17 0 17 17 0 16
16 0 0 17 0 17 0 17 0 0 0 0 0 17 0 17 0 17 0 0 16
16 0 17 17 17 17 0 17 17 17 0 17 17 17 0 17 17 17 17 0 16
16 0 17 0 0 0 0 0 0 17 0 17 0 0 0 0 0 0 17 0 16
16 0 17 17 17 17 17 17 17 17 17 17 17 17 17 17 17 17 17 0 16
16 0 0 0 0 0 0 0 0 0 0 0 0 0 0 0 0 0 0 0 16